Year,Jurisdiction,Commodity Group,Import value (dollars),Export value (dollars),Balance of trade (dollars)
2000,Canada,Primary Wood Products,705890364,738744021,32853657
2000,Canada,Pulp and Paper Products,6832099423,27865092589,21032993166
2000,Canada,Wood-Fabricated Materials,2432885441,19116818624,16683933183
2000,Alberta,Primary Wood Products,1060259,40320536,39260277
2000,Alberta,Pulp and Paper Products,171161790,1904378662,1733216872
2000,Alberta,Wood-Fabricated Materials,64631409,1266141738,1201510329
2000,British Columbia,Primary Wood Products,117252767,491880210,374627443
2000,British Columbia,Pulp and Paper Products,602960598,6940851125,6337890527
2000,British Columbia,Wood-Fabricated Materials,520821789,8871467271,8350645482
2000,Manitoba,Primary Wood Products,3331461,6598249,3266788
2000,Manitoba,Pulp and Paper Products,279404130,276786138,-2617992
2000,Manitoba,Wood-Fabricated Materials,89312020,365819197,276507177
2000,New Brunswick,Primary Wood Products,71769297,5382135,-66387162
2000,New Brunswick,Pulp and Paper Products,138640804,1878748915,1740108111
2000,New Brunswick,Wood-Fabricated Materials,64063021,982372700,918309679
2000,Newfoundland and Labrador,Primary Wood Products,1571,0,-1571
2000,Newfoundland and Labrador,Pulp and Paper Products,17791496,654200315,636408819
2000,Newfoundland and Labrador,Wood-Fabricated Materials,365580,30803061,30437481
2000,Northwest Territories,Primary Wood Products,0,12129,12129
2000,Northwest Territories,Pulp and Paper Products,372,0,-372
2000,Northwest Territories,Wood-Fabricated Materials,0,4358578,4358578
2000,Nova Scotia,Primary Wood Products,36615,20915312,20878697
2000,Nova Scotia,Pulp and Paper Products,17843308,786821052,768977744
2000,Nova Scotia,Wood-Fabricated Materials,8443400,276025879,267582479
2000,Ontario,Primary Wood Products,124674181,120083722,-4590459
2000,Ontario,Pulp and Paper Products,4519712761,6795404814,2275692053
2000,Ontario,Wood-Fabricated Materials,1252757353,2855634368,1602877015
2000,Prince Edward Island,Primary Wood Products,48360,32183,-16177
2000,Prince Edward Island,Pulp and Paper Products,37012,1750879,1713867
2000,Prince Edward Island,Wood-Fabricated Materials,184001,16002789,15818788
2000,Quebec,Primary Wood Products,387544268,48151409,-339392859
2000,Quebec,Pulp and Paper Products,1026766227,7976717874,6949951647
2000,Quebec,Wood-Fabricated Materials,394615120,4203367209,3808752089
2000,Saskatchewan,Primary Wood Products,166921,5227849,5060928
2000,Saskatchewan,Pulp and Paper Products,57779580,649432815,591653235
2000,Saskatchewan,Wood-Fabricated Materials,37682645,233082291,195399646
2000,Yukon,Primary Wood Products,4664,140287,135623
2000,Yukon,Pulp and Paper Products,1345,0,-1345
2000,Yukon,Wood-Fabricated Materials,9103,11743543,11734440
2001,Canada,Primary Wood Products,714633900,769354946,54721046
2001,Canada,Pulp and Paper Products,6854267794,25747593394,18893325600
2001,Canada,Wood-Fabricated Materials,2296866668,18259156897,15962290229
2001,Alberta,Primary Wood Products,534421,25562238,25027817
2001,Alberta,Pulp and Paper Products,185032492,1600640299,1415607807
2001,Alberta,Wood-Fabricated Materials,62150817,1230814632,1168663815
2001,British Columbia,Primary Wood Products,84128987,521733847,437604860
2001,British Columbia,Pulp and Paper Products,656647662,5569275416,4912627754
2001,British Columbia,Wood-Fabricated Materials,478512769,8527173756,8048660987
2001,Manitoba,Primary Wood Products,1606751,3408230,1801479
2001,Manitoba,Pulp and Paper Products,281281675,259533795,-21747880
2001,Manitoba,Wood-Fabricated Materials,94241270,330728909,236487639
2001,New Brunswick,Primary Wood Products,110111832,7947682,-102164150
2001,New Brunswick,Pulp and Paper Products,122503874,1551363430,1428859556
2001,New Brunswick,Wood-Fabricated Materials,58465205,904653073,846187868
2001,Newfoundland and Labrador,Primary Wood Products,5,0,-5
2001,Newfoundland and Labrador,Pulp and Paper Products,16455241,688937038,672481797
2001,Newfoundland and Labrador,Wood-Fabricated Materials,301658,30376403,30074745
2001,Northwest Territories,Primary Wood Products,1532,146002,144470
2001,Northwest Territories,Pulp and Paper Products,5235,0,-5235
2001,Northwest Territories,Wood-Fabricated Materials,0,926431,926431
2001,Nova Scotia,Primary Wood Products,32785,26146395,26113610
2001,Nova Scotia,Pulp and Paper Products,22052684,864981205,842928521
2001,Nova Scotia,Wood-Fabricated Materials,12097336,247648004,235550668
2001,Ontario,Primary Wood Products,110217745,128709784,18492039
2001,Ontario,Pulp and Paper Products,4495703270,6583898159,2088194889
2001,Ontario,Wood-Fabricated Materials,1173698101,2774369207,1600671106
2001,Prince Edward Island,Primary Wood Products,40038,8170,-31868
2001,Prince Edward Island,Pulp and Paper Products,17985,1375039,1357054
2001,Prince Edward Island,Wood-Fabricated Materials,27536,13330772,13303236
2001,Quebec,Primary Wood Products,407515285,50622408,-356892877
2001,Quebec,Pulp and Paper Products,997646898,8131046932,7133400034
2001,Quebec,Wood-Fabricated Materials,382416065,4040906704,3658490639
2001,Saskatchewan,Primary Wood Products,444519,4598757,4154238
2001,Saskatchewan,Pulp and Paper Products,76920682,496542081,419621399
2001,Saskatchewan,Wood-Fabricated Materials,34907668,155702500,120794832
2001,Yukon,Primary Wood Products,0,471433,471433
2001,Yukon,Pulp and Paper Products,96,0,-96
2001,Yukon,Wood-Fabricated Materials,48243,2526506,2478263
2002,Canada,Primary Wood Products,701428489,913360680,211932191
2002,Canada,Pulp and Paper Products,7086824258,24288088901,17201264643
2002,Canada,Wood-Fabricated Materials,2677864757,18002925220,15325060463
2002,Alberta,Primary Wood Products,727990,31479710,30751720
2002,Alberta,Pulp and Paper Products,172518160,1519140168,1346622008
2002,Alberta,Wood-Fabricated Materials,61924478,1234938780,1173014302
2002,British Columbia,Primary Wood Products,77061993,650803542,573741549
2002,British Columbia,Pulp and Paper Products,636227025,5075141021,4438913996
2002,British Columbia,Wood-Fabricated Materials,536922748,8304492125,7767569377
2002,Manitoba,Primary Wood Products,1175467,2183924,1008457
2002,Manitoba,Pulp and Paper Products,280124906,275704017,-4420889
2002,Manitoba,Wood-Fabricated Materials,109732282,337286061,227553779
2002,New Brunswick,Primary Wood Products,79782131,10774233,-69007898
2002,New Brunswick,Pulp and Paper Products,125950684,1465805145,1339854461
2002,New Brunswick,Wood-Fabricated Materials,71038814,875504210,804465396
2002,Newfoundland and Labrador,Primary Wood Products,29847,0,-29847
2002,Newfoundland and Labrador,Pulp and Paper Products,16633076,753330449,736697373
2002,Newfoundland and Labrador,Wood-Fabricated Materials,161115,28642395,28481280
2002,Northwest Territories,Pulp and Paper Products,65,12000,11935
2002,Northwest Territories,Wood-Fabricated Materials,0,6642,6642
2002,Nova Scotia,Primary Wood Products,10214,36503704,36493490
2002,Nova Scotia,Pulp and Paper Products,28133141,730129508,701996367
2002,Nova Scotia,Wood-Fabricated Materials,20413109,255188342,234775233
2002,Nunavut,Pulp and Paper Products,0,733,733
2002,Ontario,Primary Wood Products,112666191,130094118,17427927
2002,Ontario,Pulp and Paper Products,4641701863,6373799407,1732097544
2002,Ontario,Wood-Fabricated Materials,1343714819,2810452089,1466737270
2002,Prince Edward Island,Primary Wood Products,0,3447,3447
2002,Prince Edward Island,Pulp and Paper Products,56557,547612,491055
2002,Prince Edward Island,Wood-Fabricated Materials,59868,14201191,14141323
2002,Quebec,Primary Wood Products,429553934,47358023,-382195911
2002,Quebec,Pulp and Paper Products,1113952379,7624604036,6510651657
2002,Quebec,Wood-Fabricated Materials,496898520,3983030912,3486132392
2002,Saskatchewan,Primary Wood Products,420722,4073097,3652375
2002,Saskatchewan,Pulp and Paper Products,71525726,469874805,398349079
2002,Saskatchewan,Wood-Fabricated Materials,36877662,158578144,121700482
2002,Yukon,Primary Wood Products,0,86882,86882
2002,Yukon,Pulp and Paper Products,676,0,-676
2002,Yukon,Wood-Fabricated Materials,121342,604329,482987
2003,Canada,Primary Wood Products,632384546,824809278,192424732
2003,Canada,Pulp and Paper Products,6699913481,22110080103,15410166622
2003,Canada,Wood-Fabricated Materials,2677328117,16854552522,14177224405
2003,Alberta,Primary Wood Products,814470,25288697,24474227
2003,Alberta,Pulp and Paper Products,162736126,1399696036,1236959910
2003,Alberta,Wood-Fabricated Materials,73062806,1332004513,1258941707
2003,British Columbia,Primary Wood Products,63559016,580642844,517083828
2003,British Columbia,Pulp and Paper Products,613791994,4766358212,4152566218
2003,British Columbia,Wood-Fabricated Materials,559122190,7334331566,6775209376
2003,Manitoba,Primary Wood Products,1663208,2467853,804645
2003,Manitoba,Pulp and Paper Products,267328381,285696527,18368146
2003,Manitoba,Wood-Fabricated Materials,109832014,355194450,245362436
2003,New Brunswick,Primary Wood Products,84489213,9973824,-74515389
2003,New Brunswick,Pulp and Paper Products,112391067,1444275368,1331884301
2003,New Brunswick,Wood-Fabricated Materials,61651370,827090600,765439230
2003,Newfoundland and Labrador,Primary Wood Products,0,35727,35727
2003,Newfoundland and Labrador,Pulp and Paper Products,15381333,543901771,528520438
2003,Newfoundland and Labrador,Wood-Fabricated Materials,235036,9186288,8951252
2003,Northwest Territories,Pulp and Paper Products,549,0,-549
2003,Northwest Territories,Wood-Fabricated Materials,132,0,-132
2003,Nova Scotia,Primary Wood Products,0,31446930,31446930
2003,Nova Scotia,Pulp and Paper Products,27903748,684181524,656277776
2003,Nova Scotia,Wood-Fabricated Materials,22414331,201976659,179562328
2003,Nunavut,Pulp and Paper Products,0,1815,1815
2003,Ontario,Primary Wood Products,102932734,121620003,18687269
2003,Ontario,Pulp and Paper Products,4379786651,5661744538,1281957887
2003,Ontario,Wood-Fabricated Materials,1305976944,2793402057,1487425113
2003,Prince Edward Island,Primary Wood Products,12,90021,90009
2003,Prince Edward Island,Pulp and Paper Products,45037,97073,52036
2003,Prince Edward Island,Wood-Fabricated Materials,61083,12888466,12827383
2003,Quebec,Primary Wood Products,378525523,48432209,-330093314
2003,Quebec,Pulp and Paper Products,1053057682,6892661217,5839603535
2003,Quebec,Wood-Fabricated Materials,512673175,3782632052,3269958877
2003,Saskatchewan,Primary Wood Products,400370,4795532,4395162
2003,Saskatchewan,Pulp and Paper Products,67490278,431466022,363975744
2003,Saskatchewan,Wood-Fabricated Materials,32297676,205278226,172980550
2003,Yukon,Primary Wood Products,0,15638,15638
2003,Yukon,Pulp and Paper Products,635,0,-635
2003,Yukon,Wood-Fabricated Materials,1360,567645,566285
2004,Canada,Primary Wood Products,649874673,808976688,159102015
2004,Canada,Pulp and Paper Products,6700861502,22806935015,16106073513
2004,Canada,Wood-Fabricated Materials,2926896896,21172592186,18245695290
2004,Alberta,Primary Wood Products,2396725,30421491,28024766
2004,Alberta,Pulp and Paper Products,183342047,1467381882,1284039835
2004,Alberta,Wood-Fabricated Materials,100896027,1902323301,1801427274
2004,British Columbia,Primary Wood Products,46224121,564080018,517855897
2004,British Columbia,Pulp and Paper Products,660687237,5035587971,4374900734
2004,British Columbia,Wood-Fabricated Materials,668860377,9192662311,8523801934
2004,Manitoba,Primary Wood Products,1771658,1795694,24036
2004,Manitoba,Pulp and Paper Products,263567397,281997514,18430117
2004,Manitoba,Wood-Fabricated Materials,104879310,460182414,355303104
2004,New Brunswick,Primary Wood Products,82532264,9097608,-73434656
2004,New Brunswick,Pulp and Paper Products,108221580,1382332232,1274110652
2004,New Brunswick,Wood-Fabricated Materials,61845281,1073017016,1011171735
2004,Newfoundland and Labrador,Primary Wood Products,0,5748,5748
2004,Newfoundland and Labrador,Pulp and Paper Products,12114407,507766347,495651940
2004,Newfoundland and Labrador,Wood-Fabricated Materials,173676,14807620,14633944
2004,Nova Scotia,Primary Wood Products,13744,27139795,27126051
2004,Nova Scotia,Pulp and Paper Products,23781950,740340306,716558356
2004,Nova Scotia,Wood-Fabricated Materials,30900226,264880346,233980120
2004,Nunavut,Pulp and Paper Products,0,1058,1058
2004,Nunavut,Wood-Fabricated Materials,0,27723,27723
2004,Ontario,Primary Wood Products,106566368,121149346,14582978
2004,Ontario,Pulp and Paper Products,4276973557,5689742842,1412769285
2004,Ontario,Wood-Fabricated Materials,1347178912,3242474199,1895295287
2004,Prince Edward Island,Primary Wood Products,0,35909,35909
2004,Prince Edward Island,Pulp and Paper Products,22164,752865,730701
2004,Prince Edward Island,Wood-Fabricated Materials,20687,18157903,18137216
2004,Quebec,Primary Wood Products,410160245,49898093,-360262152
2004,Quebec,Pulp and Paper Products,1118362984,7264001742,6145638758
2004,Quebec,Wood-Fabricated Materials,581264327,4635061892,4053797565
2004,Saskatchewan,Primary Wood Products,209548,5252327,5042779
2004,Saskatchewan,Pulp and Paper Products,53782240,437030256,383248016
2004,Saskatchewan,Wood-Fabricated Materials,30872123,368136278,337264155
2004,Yukon,Primary Wood Products,0,100659,100659
2004,Yukon,Pulp and Paper Products,5939,0,-5939
2004,Yukon,Wood-Fabricated Materials,5950,861183,855233
2005,Canada,Primary Wood Products,628691679,942695609,314003930
2005,Canada,Pulp and Paper Products,6626196017,21843674303,15217478286
2005,Canada,Wood-Fabricated Materials,2907547019,19335403331,16427856312
2005,Alberta,Primary Wood Products,1461134,25220017,23758883
2005,Alberta,Pulp and Paper Products,177061444,1414815533,1237754089
2005,Alberta,Wood-Fabricated Materials,140039729,1576375746,1436336017
2005,British Columbia,Primary Wood Products,45588556,702040585,656452029
2005,British Columbia,Pulp and Paper Products,676306795,4656692437,3980385642
2005,British Columbia,Wood-Fabricated Materials,664949682,8461293800,7796344118
2005,Manitoba,Primary Wood Products,2602548,1960037,-642511
2005,Manitoba,Pulp and Paper Products,268557301,285592386,17035085
2005,Manitoba,Wood-Fabricated Materials,119466624,446872261,327405637
2005,New Brunswick,Primary Wood Products,91225518,7661162,-83564356
2005,New Brunswick,Pulp and Paper Products,112940199,975580589,862640390
2005,New Brunswick,Wood-Fabricated Materials,59028102,950337197,891309095
2005,Newfoundland and Labrador,Primary Wood Products,12959,4410,-8549
2005,Newfoundland and Labrador,Pulp and Paper Products,11340819,526191065,514850246
2005,Newfoundland and Labrador,Wood-Fabricated Materials,172211,11801764,11629553
2005,Northwest Territories,Pulp and Paper Products,24,0,-24
2005,Nova Scotia,Primary Wood Products,28290,18215008,18186718
2005,Nova Scotia,Pulp and Paper Products,21671634,763290331,741618697
2005,Nova Scotia,Wood-Fabricated Materials,29537540,251624080,222086540
2005,Nunavut,Pulp and Paper Products,0,932,932
2005,Ontario,Primary Wood Products,88895445,120079436,31183991
2005,Ontario,Pulp and Paper Products,4222336962,5377810871,1155473909
2005,Ontario,Wood-Fabricated Materials,1263473584,2946675765,1683202181
2005,Prince Edward Island,Primary Wood Products,0,54486,54486
2005,Prince Edward Island,Pulp and Paper Products,68517,5181599,5113082
2005,Prince Edward Island,Wood-Fabricated Materials,26836,16688550,16661714
2005,Quebec,Primary Wood Products,398374669,60911063,-337463606
2005,Quebec,Pulp and Paper Products,1097455542,7401356873,6303901331
2005,Quebec,Wood-Fabricated Materials,600944818,4235529590,3634584772
2005,Saskatchewan,Primary Wood Products,502560,6527379,6024819
2005,Saskatchewan,Pulp and Paper Products,38444749,437161687,398716938
2005,Saskatchewan,Wood-Fabricated Materials,29903422,437321652,407418230
2005,Yukon,Primary Wood Products,0,22026,22026
2005,Yukon,Pulp and Paper Products,12031,0,-12031
2005,Yukon,Wood-Fabricated Materials,4471,882926,878455
2006,Canada,Primary Wood Products,583728465,918073266,334344801
2006,Canada,Pulp and Paper Products,6703927840,20937728277,14233800437
2006,Canada,Wood-Fabricated Materials,2976258149,16480290135,13504031986
2006,Alberta,Primary Wood Products,2071653,27388894,25317241
2006,Alberta,Pulp and Paper Products,178778003,1446409734,1267631731
2006,Alberta,Wood-Fabricated Materials,157716239,1129846683,972130444
2006,British Columbia,Primary Wood Products,47435629,662511019,615075390
2006,British Columbia,Pulp and Paper Products,697667365,4788486600,4090819235
2006,British Columbia,Wood-Fabricated Materials,708984592,7865849944,7156865352
2006,Manitoba,Primary Wood Products,803064,1090277,287213
2006,Manitoba,Pulp and Paper Products,274100976,288580580,14479604
2006,Manitoba,Wood-Fabricated Materials,116587998,334661060,218073062
2006,New Brunswick,Primary Wood Products,89337165,5237133,-84100032
2006,New Brunswick,Pulp and Paper Products,95097144,1260900934,1165803790
2006,New Brunswick,Wood-Fabricated Materials,62283944,745776590,683492646
2006,Newfoundland and Labrador,Primary Wood Products,4907,48402,43495
2006,Newfoundland and Labrador,Pulp and Paper Products,11577816,448006052,436428236
2006,Newfoundland and Labrador,Wood-Fabricated Materials,290142,6572364,6282222
2006,Northwest Territories,Pulp and Paper Products,1886,540,-1346
2006,Northwest Territories,Wood-Fabricated Materials,270,50844,50574
2006,Nova Scotia,Primary Wood Products,8116,32246632,32238516
2006,Nova Scotia,Pulp and Paper Products,19458426,441350648,421892222
2006,Nova Scotia,Wood-Fabricated Materials,27358511,214717581,187359070
2006,Nunavut,Primary Wood Products,0,15486,15486
2006,Nunavut,Pulp and Paper Products,0,145047,145047
2006,Nunavut,Wood-Fabricated Materials,0,61742,61742
2006,Ontario,Primary Wood Products,75327339,110476621,35149282
2006,Ontario,Pulp and Paper Products,4276980094,4543754196,266774102
2006,Ontario,Wood-Fabricated Materials,1262356840,2352585001,1090228161
2006,Prince Edward Island,Primary Wood Products,0,55703,55703
2006,Prince Edward Island,Pulp and Paper Products,51836,1393809,1341973
2006,Prince Edward Island,Wood-Fabricated Materials,15128,10246417,10231289
2006,Quebec,Primary Wood Products,368507294,73351012,-295156282
2006,Quebec,Pulp and Paper Products,1105989028,7488351791,6382362763
2006,Quebec,Wood-Fabricated Materials,613394181,3567103318,2953709137
2006,Saskatchewan,Primary Wood Products,233298,5510215,5276917
2006,Saskatchewan,Pulp and Paper Products,44211473,230348346,186136873
2006,Saskatchewan,Wood-Fabricated Materials,27268768,252022763,224753995
2006,Yukon,Primary Wood Products,0,141872,141872
2006,Yukon,Pulp and Paper Products,13793,0,-13793
2006,Yukon,Wood-Fabricated Materials,1536,795828,794292
2007,Canada,Primary Wood Products,553062912,799602667,246539755
2007,Canada,Pulp and Paper Products,6701904446,20208564795,13506660349
2007,Canada,Wood-Fabricated Materials,2936616181,12720108779,9783492598
2007,Alberta,Primary Wood Products,840393,27012284,26171891
2007,Alberta,Pulp and Paper Products,161425785,1388499730,1227073945
2007,Alberta,Wood-Fabricated Materials,155937911,796104791,640166880
2007,British Columbia,Primary Wood Products,77610297,564540769,486930472
2007,British Columbia,Pulp and Paper Products,727276070,5121458881,4394182811
2007,British Columbia,Wood-Fabricated Materials,720422451,6389614232,5669191781
2007,Manitoba,Primary Wood Products,830660,731690,-98970
2007,Manitoba,Pulp and Paper Products,289070023,259736303,-29333720
2007,Manitoba,Wood-Fabricated Materials,113210778,271749031,158538253
2007,New Brunswick,Primary Wood Products,86048968,7559515,-78489453
2007,New Brunswick,Pulp and Paper Products,101596556,1342071670,1240475114
2007,New Brunswick,Wood-Fabricated Materials,52678520,498132432,445453912
2007,Newfoundland and Labrador,Primary Wood Products,11751,5033,-6718
2007,Newfoundland and Labrador,Pulp and Paper Products,11726369,341051442,329325073
2007,Newfoundland and Labrador,Wood-Fabricated Materials,60255,6173090,6112835
2007,Northwest Territories,Wood-Fabricated Materials,0,109108,109108
2007,Nova Scotia,Primary Wood Products,6652,31492141,31485489
2007,Nova Scotia,Pulp and Paper Products,22720423,701394463,678674040
2007,Nova Scotia,Wood-Fabricated Materials,33599729,166977877,133378148
2007,Nunavut,Pulp and Paper Products,0,149455,149455
2007,Nunavut,Wood-Fabricated Materials,0,2254,2254
2007,Ontario,Primary Wood Products,67425238,93406104,25980866
2007,Ontario,Pulp and Paper Products,4221098622,4115519378,-105579244
2007,Ontario,Wood-Fabricated Materials,1264672611,1677182051,412509440
2007,Prince Edward Island,Primary Wood Products,0,37723,37723
2007,Prince Edward Island,Pulp and Paper Products,9384,928646,919262
2007,Prince Edward Island,Wood-Fabricated Materials,30476,5882902,5852426
2007,Quebec,Primary Wood Products,320106625,71062242,-249044383
2007,Quebec,Pulp and Paper Products,1126432457,6723895891,5597463434
2007,Quebec,Wood-Fabricated Materials,568119785,2776972304,2208852519
2007,Saskatchewan,Primary Wood Products,182328,3690829,3508501
2007,Saskatchewan,Pulp and Paper Products,40542011,213801946,173259935
2007,Saskatchewan,Wood-Fabricated Materials,27875656,130258785,102383129
2007,Yukon,Primary Wood Products,0,64337,64337
2007,Yukon,Pulp and Paper Products,6746,56990,50244
2007,Yukon,Wood-Fabricated Materials,8009,949922,941913
2008,Canada,Primary Wood Products,508289050,696344790,188055740
2008,Canada,Pulp and Paper Products,6809491258,20359605102,13550113844
2008,Canada,Wood-Fabricated Materials,2808757209,9138862845,6330105636
2008,Alberta,Primary Wood Products,3430992,27011474,23580482
2008,Alberta,Pulp and Paper Products,154560134,1609272977,1454712843
2008,Alberta,Wood-Fabricated Materials,139614009,529350232,389736223
2008,British Columbia,Primary Wood Products,68549166,479808135,411258969
2008,British Columbia,Pulp and Paper Products,709479492,4699274715,3989795223
2008,British Columbia,Wood-Fabricated Materials,725039866,4773050940,4048011074
2008,Manitoba,Primary Wood Products,2197206,575516,-1621690
2008,Manitoba,Pulp and Paper Products,319865965,288993780,-30872185
2008,Manitoba,Wood-Fabricated Materials,119452542,182664807,63212265
2008,New Brunswick,Primary Wood Products,74216992,12269833,-61947159
2008,New Brunswick,Pulp and Paper Products,112733538,1089735582,977002044
2008,New Brunswick,Wood-Fabricated Materials,48411067,316560201,268149134
2008,Newfoundland and Labrador,Primary Wood Products,0,21475,21475
2008,Newfoundland and Labrador,Pulp and Paper Products,11181475,337279170,326097695
2008,Newfoundland and Labrador,Wood-Fabricated Materials,73533,2727721,2654188
2008,Northwest Territories,Wood-Fabricated Materials,0,80362,80362
2008,Nova Scotia,Primary Wood Products,11142,30974519,30963377
2008,Nova Scotia,Pulp and Paper Products,18005266,804025936,786020670
2008,Nova Scotia,Wood-Fabricated Materials,34626050,103242192,68616142
2008,Nunavut,Pulp and Paper Products,0,35109,35109
2008,Nunavut,Wood-Fabricated Materials,0,9202,9202
2008,Ontario,Primary Wood Products,76205768,64709663,-11496105
2008,Ontario,Pulp and Paper Products,4223604341,4171015195,-52589146
2008,Ontario,Wood-Fabricated Materials,1184736220,1170836586,-13899634
2008,Prince Edward Island,Primary Wood Products,0,15230,15230
2008,Prince Edward Island,Pulp and Paper Products,21738,825917,804179
2008,Prince Edward Island,Wood-Fabricated Materials,77647,2166966,2089319
2008,Quebec,Primary Wood Products,282126496,76536324,-205590172
2008,Quebec,Pulp and Paper Products,1226709879,7152400259,5925690380
2008,Quebec,Wood-Fabricated Materials,524733144,2004046359,1479313215
2008,Saskatchewan,Primary Wood Products,1550171,4367359,2817188
2008,Saskatchewan,Pulp and Paper Products,33315077,206741174,173426097
2008,Saskatchewan,Wood-Fabricated Materials,31988561,53686043,21697482
2008,Yukon,Primary Wood Products,1117,55262,54145
2008,Yukon,Pulp and Paper Products,14353,5288,-9065
2008,Yukon,Wood-Fabricated Materials,4570,441234,436664
2009,Canada,Primary Wood Products,487345461,654732086,167386625
2009,Canada,Pulp and Paper Products,6332453314,16059767237,9727313923
2009,Canada,Wood-Fabricated Materials,2394487091,6790537158,4396050067
2009,Alberta,Primary Wood Products,4413346,20878064,16464718
2009,Alberta,Pulp and Paper Products,157330448,1315396858,1158066410
2009,Alberta,Wood-Fabricated Materials,135765510,483110733,347345223
2009,British Columbia,Primary Wood Products,50495587,465300900,414805313
2009,British Columbia,Pulp and Paper Products,648031896,3475863347,2827831451
2009,British Columbia,Wood-Fabricated Materials,592418058,3552836615,2960418557
2009,Manitoba,Primary Wood Products,1072880,668853,-404027
2009,Manitoba,Pulp and Paper Products,312517030,224538738,-87978292
2009,Manitoba,Wood-Fabricated Materials,105197712,103240042,-1957670
2009,New Brunswick,Primary Wood Products,60977833,12459298,-48518535
2009,New Brunswick,Pulp and Paper Products,110093200,1015642438,905549238
2009,New Brunswick,Wood-Fabricated Materials,43006107,266472788,223466681
2009,Newfoundland and Labrador,Primary Wood Products,5500,4000,-1500
2009,Newfoundland and Labrador,Pulp and Paper Products,5479164,166260882,160781718
2009,Newfoundland and Labrador,Wood-Fabricated Materials,257943,1917929,1659986
2009,Northwest Territories,Pulp and Paper Products,0,33178,33178
2009,Northwest Territories,Wood-Fabricated Materials,0,45848,45848
2009,Nova Scotia,Primary Wood Products,71265,30218580,30147315
2009,Nova Scotia,Pulp and Paper Products,20253477,574215713,553962236
2009,Nova Scotia,Wood-Fabricated Materials,32796135,69084900,36288765
2009,Nunavut,Primary Wood Products,335,0,-335
2009,Nunavut,Pulp and Paper Products,815,357,-458
2009,Nunavut,Wood-Fabricated Materials,687,34816,34129
2009,Ontario,Primary Wood Products,57580394,54576709,-3003685
2009,Ontario,Pulp and Paper Products,3940113668,3310775590,-629338078
2009,Ontario,Wood-Fabricated Materials,998479692,775773096,-222706596
2009,Prince Edward Island,Primary Wood Products,121,11434,11313
2009,Prince Edward Island,Pulp and Paper Products,5191,1893560,1888369
2009,Prince Edward Island,Wood-Fabricated Materials,49806,1392757,1342951
2009,Quebec,Primary Wood Products,311482637,67781022,-243701615
2009,Quebec,Pulp and Paper Products,1099482630,5772490892,4673008262
2009,Quebec,Wood-Fabricated Materials,454974686,1488796854,1033822168
2009,Saskatchewan,Primary Wood Products,1245351,2799090,1553739
2009,Saskatchewan,Pulp and Paper Products,39131002,202655684,163524682
2009,Saskatchewan,Wood-Fabricated Materials,31536935,47683358,16146423
2009,Yukon,Primary Wood Products,212,34136,33924
2009,Yukon,Pulp and Paper Products,14793,0,-14793
2009,Yukon,Wood-Fabricated Materials,3820,147422,143602
2010,Canada,Primary Wood Products,448949354,844658429,395709075
2010,Canada,Pulp and Paper Products,6293823387,17167343788,10873520401
2010,Canada,Wood-Fabricated Materials,2679099966,7898887883,5219787917
2010,Alberta,Primary Wood Products,3015477,21736763,18721286
2010,Alberta,Pulp and Paper Products,141049331,1601889167,1460839836
2010,Alberta,Wood-Fabricated Materials,147603479,622050752,474447273
2010,British Columbia,Primary Wood Products,42051573,646147764,604096191
2010,British Columbia,Pulp and Paper Products,675935294,4037687784,3361752490
2010,British Columbia,Wood-Fabricated Materials,691672654,4349096169,3657423515
2010,Manitoba,Primary Wood Products,2102313,437678,-1664635
2010,Manitoba,Pulp and Paper Products,293251609,198758750,-94492859
2010,Manitoba,Wood-Fabricated Materials,109066233,85775644,-23290589
2010,New Brunswick,Primary Wood Products,65692587,15486795,-50205792
2010,New Brunswick,Pulp and Paper Products,112427160,1197972672,1085545512
2010,New Brunswick,Wood-Fabricated Materials,50378524,342044396,291665872
2010,Newfoundland and Labrador,Primary Wood Products,11699,12991,1292
2010,Newfoundland and Labrador,Pulp and Paper Products,5739734,113619928,107880194
2010,Newfoundland and Labrador,Wood-Fabricated Materials,113318,3166278,3052960
2010,Northwest Territories,Pulp and Paper Products,4501,52470,47969
2010,Northwest Territories,Wood-Fabricated Materials,0,13852,13852
2010,Nova Scotia,Primary Wood Products,111286,51227712,51116426
2010,Nova Scotia,Pulp and Paper Products,19323578,652929077,633605499
2010,Nova Scotia,Wood-Fabricated Materials,32466279,93025687,60559408
2010,Nunavut,Pulp and Paper Products,0,293152,293152
2010,Nunavut,Wood-Fabricated Materials,0,2642,2642
2010,Ontario,Primary Wood Products,47606734,57546540,9939806
2010,Ontario,Pulp and Paper Products,3912190305,3342609440,-569580865
2010,Ontario,Wood-Fabricated Materials,1093242380,790535879,-302706501
2010,Prince Edward Island,Primary Wood Products,0,18572,18572
2010,Prince Edward Island,Pulp and Paper Products,7017,7787001,7779984
2010,Prince Edward Island,Wood-Fabricated Materials,76369,130189,53820
2010,Quebec,Primary Wood Products,286948009,49840921,-237107088
2010,Quebec,Pulp and Paper Products,1098118271,5842511061,4744392790
2010,Quebec,Wood-Fabricated Materials,519384122,1561257222,1041873100
2010,Saskatchewan,Primary Wood Products,1409676,2198261,788585
2010,Saskatchewan,Pulp and Paper Products,35757008,171225148,135468140
2010,Saskatchewan,Wood-Fabricated Materials,35096548,51500150,16403602
2010,Yukon,Primary Wood Products,0,4432,4432
2010,Yukon,Pulp and Paper Products,19579,8138,-11441
2010,Yukon,Wood-Fabricated Materials,60,289023,288963
2011,Canada,Primary Wood Products,391915585,1057493153,665577568
2011,Canada,Pulp and Paper Products,6187759745,17298164087,11110404342
2011,Canada,Wood-Fabricated Materials,2558866654,8014465626,5455598972
2011,Alberta,Primary Wood Products,5262998,20800739,15537741
2011,Alberta,Pulp and Paper Products,148415870,1524095472,1375679602
2011,Alberta,Wood-Fabricated Materials,172085971,478060774,305974803
2011,British Columbia,Primary Wood Products,49578229,889659721,840081492
2011,British Columbia,Pulp and Paper Products,684546384,4280528204,3595981820
2011,British Columbia,Wood-Fabricated Materials,677222330,4706643374,4029421044
2011,Manitoba,Primary Wood Products,2254564,519625,-1734939
2011,Manitoba,Pulp and Paper Products,273114251,230953523,-42160728
2011,Manitoba,Wood-Fabricated Materials,109061252,85589645,-23471607
2011,New Brunswick,Primary Wood Products,67085544,22520448,-44565096
2011,New Brunswick,Pulp and Paper Products,101250342,1145865789,1044615447
2011,New Brunswick,Wood-Fabricated Materials,46971416,344793990,297822574
2011,Newfoundland and Labrador,Primary Wood Products,20081,11642,-8439
2011,Newfoundland and Labrador,Pulp and Paper Products,5147599,156372935,151225336
2011,Newfoundland and Labrador,Wood-Fabricated Materials,149725,3373041,3223316
2011,Northwest Territories,Pulp and Paper Products,4331,47208,42877
2011,Northwest Territories,Wood-Fabricated Materials,0,82781,82781
2011,Nova Scotia,Primary Wood Products,0,19774114,19774114
2011,Nova Scotia,Pulp and Paper Products,17511721,619457887,601946166
2011,Nova Scotia,Wood-Fabricated Materials,32697626,80323453,47625827
2011,Nunavut,Primary Wood Products,52,26190,26138
2011,Nunavut,Pulp and Paper Products,383,5511,5128
2011,Nunavut,Wood-Fabricated Materials,235,37509,37274
2011,Ontario,Primary Wood Products,46825021,51769529,4944508
2011,Ontario,Pulp and Paper Products,3821689005,3421838351,-399850654
2011,Ontario,Wood-Fabricated Materials,1038493110,736421643,-302071467
2011,Prince Edward Island,Primary Wood Products,0,15955,15955
2011,Prince Edward Island,Pulp and Paper Products,9731,1673886,1664155
2011,Prince Edward Island,Wood-Fabricated Materials,18056,139588,121532
2011,Quebec,Primary Wood Products,218746149,50073685,-168672464
2011,Quebec,Pulp and Paper Products,1097143706,5715322844,4618179138
2011,Quebec,Wood-Fabricated Materials,437912427,1509375786,1071463359
2011,Saskatchewan,Primary Wood Products,2142947,2308554,165607
2011,Saskatchewan,Pulp and Paper Products,38918416,202002477,163084061
2011,Saskatchewan,Wood-Fabricated Materials,44221386,69211355,24989969
2011,Yukon,Primary Wood Products,0,12951,12951
2011,Yukon,Pulp and Paper Products,8006,0,-8006
2011,Yukon,Wood-Fabricated Materials,33120,412687,379567
2012,Canada,Primary Wood Products,419796922,1030956798,611159876
2012,Canada,Pulp and Paper Products,5768194991,15219292815,9451097824
2012,Canada,Wood-Fabricated Materials,2681365567,8975389026,6294023459
2012,Alberta,Primary Wood Products,6811771,24634588,17822817
2012,Alberta,Pulp and Paper Products,133633301,1596801759,1463168458
2012,Alberta,Wood-Fabricated Materials,148326219,521055279,372729060
2012,British Columbia,Primary Wood Products,50682093,858690617,808008524
2012,British Columbia,Pulp and Paper Products,666759361,3985924939,3319165578
2012,British Columbia,Wood-Fabricated Materials,708728117,5203166611,4494438494
2012,Manitoba,Primary Wood Products,2057472,449766,-1607706
2012,Manitoba,Pulp and Paper Products,265647594,231852671,-33794923
2012,Manitoba,Wood-Fabricated Materials,145475230,109671619,-35803611
2012,New Brunswick,Primary Wood Products,67985287,31313432,-36671855
2012,New Brunswick,Pulp and Paper Products,103779027,1017437988,913658961
2012,New Brunswick,Wood-Fabricated Materials,46805182,372868155,326062973
2012,Newfoundland and Labrador,Primary Wood Products,19967,3500,-16467
2012,Newfoundland and Labrador,Pulp and Paper Products,5683877,114323891,108640014
2012,Newfoundland and Labrador,Wood-Fabricated Materials,261549,3748159,3486610
2012,Northwest Territories,Pulp and Paper Products,0,7200,7200
2012,Northwest Territories,Wood-Fabricated Materials,0,120970,120970
2012,Nova Scotia,Primary Wood Products,0,21742550,21742550
2012,Nova Scotia,Pulp and Paper Products,15982762,290503897,274521135
2012,Nova Scotia,Wood-Fabricated Materials,29568596,72231393,42662797
2012,Nunavut,Pulp and Paper Products,0,68050,68050
2012,Ontario,Primary Wood Products,43363942,33216123,-10147819
2012,Ontario,Pulp and Paper Products,3487677721,2682395691,-805282030
2012,Ontario,Wood-Fabricated Materials,1094841876,865638609,-229203267
2012,Prince Edward Island,Primary Wood Products,0,9750,9750
2012,Prince Edward Island,Pulp and Paper Products,0,1397128,1397128
2012,Prince Edward Island,Wood-Fabricated Materials,20312,216281,195969
2012,Quebec,Primary Wood Products,247063549,58163999,-188899550
2012,Quebec,Pulp and Paper Products,1050534039,5095783431,4045249392
2012,Quebec,Wood-Fabricated Materials,474232665,1654876902,1180644237
2012,Saskatchewan,Primary Wood Products,1812091,2732473,920382
2012,Saskatchewan,Pulp and Paper Products,38447045,202789991,164342946
2012,Saskatchewan,Wood-Fabricated Materials,33099158,171666009,138566851
2012,Yukon,Primary Wood Products,750,0,-750
2012,Yukon,Pulp and Paper Products,50264,6179,-44085
2012,Yukon,Wood-Fabricated Materials,6663,129039,122376
2013,Canada,Primary Wood Products,460969015,1273094650,812125635
2013,Canada,Pulp and Paper Products,6080415464,15809268734,9728853270
2013,Canada,Wood-Fabricated Materials,2805737511,11430716206,8624978695
2013,Alberta,Primary Wood Products,7693674,23389645,15695971
2013,Alberta,Pulp and Paper Products,179402560,1638982603,1459580043
2013,Alberta,Wood-Fabricated Materials,158886101,689099445,530213344
2013,British Columbia,Primary Wood Products,68114680,1095444587,1027329907
2013,British Columbia,Pulp and Paper Products,712006275,3910276211,3198269936
2013,British Columbia,Wood-Fabricated Materials,782269502,6517847140,5735577638
2013,Manitoba,Primary Wood Products,2356192,362999,-1993193
2013,Manitoba,Pulp and Paper Products,274730958,229176625,-45554333
2013,Manitoba,Wood-Fabricated Materials,141890040,135535114,-6354926
2013,New Brunswick,Primary Wood Products,61708598,28024097,-33684501
2013,New Brunswick,Pulp and Paper Products,115118797,1017946077,902827280
2013,New Brunswick,Wood-Fabricated Materials,43433501,461583329,418149828
2013,Newfoundland and Labrador,Primary Wood Products,10615,62240,51625
2013,Newfoundland and Labrador,Pulp and Paper Products,7696707,94608798,86912091
2013,Newfoundland and Labrador,Wood-Fabricated Materials,203417,5771962,5568545
2013,Northwest Territories,Wood-Fabricated Materials,0,43426,43426
2013,Nova Scotia,Primary Wood Products,288,17030281,17029993
2013,Nova Scotia,Pulp and Paper Products,20773789,521626850,500853061
2013,Nova Scotia,Wood-Fabricated Materials,31733731,97699128,65965397
2013,Nunavut,Pulp and Paper Products,0,28679,28679
2013,Nunavut,Wood-Fabricated Materials,0,19987,19987
2013,Ontario,Primary Wood Products,48081556,35343451,-12738105
2013,Ontario,Pulp and Paper Products,3662086566,2571969001,-1090117565
2013,Ontario,Wood-Fabricated Materials,1134062933,1134163723,100790
2013,Prince Edward Island,Primary Wood Products,0,6099,6099
2013,Prince Edward Island,Pulp and Paper Products,275,1910973,1910698
2013,Prince Edward Island,Wood-Fabricated Materials,13032,260506,247474
2013,Quebec,Primary Wood Products,271264171,71044387,-200219784
2013,Quebec,Pulp and Paper Products,1073650170,5616070565,4542420395
2013,Quebec,Wood-Fabricated Materials,477823973,2155019137,1677195164
2013,Saskatchewan,Primary Wood Products,1739241,2386864,647623
2013,Saskatchewan,Pulp and Paper Products,34942220,206672352,171730132
2013,Saskatchewan,Wood-Fabricated Materials,35415196,233514402,198099206
2013,Yukon,Pulp and Paper Products,7147,0,-7147
2013,Yukon,Wood-Fabricated Materials,6085,158907,152822
2014,Canada,Primary Wood Products,498872783,1302259953,803387170
2014,Canada,Pulp and Paper Products,6529461385,16990346329,10460884944
2014,Canada,Wood-Fabricated Materials,3057639468,12666388487,9608749019
2014,Alberta,Primary Wood Products,6452167,29671579,23219412
2014,Alberta,Pulp and Paper Products,179518569,1745074107,1565555538
2014,Alberta,Wood-Fabricated Materials,158985113,923199406,764214293
2014,British Columbia,Primary Wood Products,65836734,1089902748,1024066014
2014,British Columbia,Pulp and Paper Products,781572084,4266597403,3485025319
2014,British Columbia,Wood-Fabricated Materials,881028890,6892863606,6011834716
2014,Manitoba,Primary Wood Products,2044096,402384,-1641712
2014,Manitoba,Pulp and Paper Products,291373354,254300704,-37072650
2014,Manitoba,Wood-Fabricated Materials,171676232,132893347,-38782885
2014,New Brunswick,Primary Wood Products,74740140,35605146,-39134994
2014,New Brunswick,Pulp and Paper Products,145450784,1049730854,904280070
2014,New Brunswick,Wood-Fabricated Materials,53928181,518717948,464789767
2014,Newfoundland and Labrador,Primary Wood Products,37873,12940,-24933
2014,Newfoundland and Labrador,Pulp and Paper Products,6777683,169482565,162704882
2014,Newfoundland and Labrador,Wood-Fabricated Materials,212647,4545892,4333245
2014,Northwest Territories,Pulp and Paper Products,0,12666,12666
2014,Northwest Territories,Wood-Fabricated Materials,0,9045,9045
2014,Nova Scotia,Primary Wood Products,4465,22610399,22605934
2014,Nova Scotia,Pulp and Paper Products,17411811,473204220,455792409
2014,Nova Scotia,Wood-Fabricated Materials,24435712,113113649,88677937
2014,Nunavut,Primary Wood Products,145,0,-145
2014,Nunavut,Pulp and Paper Products,480,55771,55291
2014,Nunavut,Wood-Fabricated Materials,478,360,-118
2014,Ontario,Primary Wood Products,55136239,40611431,-14524808
2014,Ontario,Pulp and Paper Products,3915244813,2790548519,-1124696294
2014,Ontario,Wood-Fabricated Materials,1225828846,1251850098,26021252
2014,Prince Edward Island,Primary Wood Products,0,15429,15429
2014,Prince Edward Island,Pulp and Paper Products,11003,6139510,6128507
2014,Prince Edward Island,Wood-Fabricated Materials,14153,180342,166189
2014,Quebec,Primary Wood Products,293228214,81097853,-212130361
2014,Quebec,Pulp and Paper Products,1159718354,6020643046,4860924692
2014,Quebec,Wood-Fabricated Materials,505047125,2606981278,2101934153
2014,Saskatchewan,Primary Wood Products,1392710,2330044,937334
2014,Saskatchewan,Pulp and Paper Products,32378849,214555266,182176417
2014,Saskatchewan,Wood-Fabricated Materials,36479717,221776804,185297087
2014,Yukon,Pulp and Paper Products,3601,1698,-1903
2014,Yukon,Wood-Fabricated Materials,2374,256712,254338
2015,Canada,Primary Wood Products,595871038,1205862076,609991038
2015,Canada,Pulp and Paper Products,7329554313,17907324191,10577769878
2015,Canada,Wood-Fabricated Materials,3249887693,13724593669,10474705976
2015,Alberta,Primary Wood Products,5568041,27167990,21599949
2015,Alberta,Pulp and Paper Products,194204869,1923002917,1728798048
2015,Alberta,Wood-Fabricated Materials,155024869,1056186652,901161783
2015,British Columbia,Primary Wood Products,67585102,971364655,903779553
2015,British Columbia,Pulp and Paper Products,867820587,4367965189,3500144602
2015,British Columbia,Wood-Fabricated Materials,944984790,7285228440,6340243650
2015,Manitoba,Primary Wood Products,3732986,672081,-3060905
2015,Manitoba,Pulp and Paper Products,324090509,264409829,-59680680
2015,Manitoba,Wood-Fabricated Materials,180895801,127086778,-53809023
2015,New Brunswick,Primary Wood Products,81839462,43945426,-37894036
2015,New Brunswick,Pulp and Paper Products,153963405,1097865639,943902234
2015,New Brunswick,Wood-Fabricated Materials,51043007,553505060,502462053
2015,Newfoundland and Labrador,Primary Wood Products,25148,6860,-18288
2015,Newfoundland and Labrador,Pulp and Paper Products,5846371,168040152,162193781
2015,Newfoundland and Labrador,Wood-Fabricated Materials,385791,4499680,4113889
2015,Northwest Territories,Pulp and Paper Products,0,12831,12831
2015,Nova Scotia,Primary Wood Products,39970,25834769,25794799
2015,Nova Scotia,Pulp and Paper Products,22879493,504357824,481478331
2015,Nova Scotia,Wood-Fabricated Materials,26728675,105814727,79086052
2015,Nunavut,Pulp and Paper Products,0,6221,6221
2015,Nunavut,Wood-Fabricated Materials,0,36525,36525
2015,Ontario,Primary Wood Products,62779100,51103575,-11675525
2015,Ontario,Pulp and Paper Products,4394192949,3035919718,-1358273231
2015,Ontario,Wood-Fabricated Materials,1316884088,1496548676,179664588
2015,Prince Edward Island,Primary Wood Products,25262,4830,-20432
2015,Prince Edward Island,Pulp and Paper Products,16200,21149924,21133724
2015,Prince Edward Island,Wood-Fabricated Materials,769,104871,104102
2015,Quebec,Primary Wood Products,373258974,82480902,-290778072
2015,Quebec,Pulp and Paper Products,1333309155,6356692669,5023383514
2015,Quebec,Wood-Fabricated Materials,537140781,2834206725,2297065944
2015,Saskatchewan,Primary Wood Products,1016993,3280988,2263995
2015,Saskatchewan,Pulp and Paper Products,33225051,167901278,134676227
2015,Saskatchewan,Wood-Fabricated Materials,36795880,261033634,224237754
2015,Yukon,Pulp and Paper Products,5724,0,-5724
2015,Yukon,Wood-Fabricated Materials,3242,341901,338659
2016,Canada,Primary Wood Products,527001296,1443412075,916410779
2016,Canada,Pulp and Paper Products,7350681460,17085549115,9734867655
2016,Canada,Wood-Fabricated Materials,3365262192,16013129905,12647867713
2016,Alberta,Primary Wood Products,2800770,19702948,16902178
2016,Alberta,Pulp and Paper Products,180093169,1794280277,1614187108
2016,Alberta,Wood-Fabricated Materials,145610622,1318544215,1172933593
2016,British Columbia,Primary Wood Products,51693749,1202878348,1151184599
2016,British Columbia,Pulp and Paper Products,821748690,3936469646,3114720956
2016,British Columbia,Wood-Fabricated Materials,1002088598,8398915183,7396826585
2016,Manitoba,Primary Wood Products,3730989,998140,-2732849
2016,Manitoba,Pulp and Paper Products,338616741,214962556,-123654185
2016,Manitoba,Wood-Fabricated Materials,160001780,222647982,62646202
2016,New Brunswick,Primary Wood Products,65459872,42953918,-22505954
2016,New Brunswick,Pulp and Paper Products,150488340,1047031886,896543546
2016,New Brunswick,Wood-Fabricated Materials,60058701,634361920,574303219
2016,Newfoundland and Labrador,Primary Wood Products,9193,27450,18257
2016,Newfoundland and Labrador,Pulp and Paper Products,4327232,146201266,141874034
2016,Newfoundland and Labrador,Wood-Fabricated Materials,152131,7964759,7812628
2016,Northwest Territories,Pulp and Paper Products,0,44510,44510
2016,Nova Scotia,Primary Wood Products,65,23302569,23302504
2016,Nova Scotia,Pulp and Paper Products,25496824,420474287,394977463
2016,Nova Scotia,Wood-Fabricated Materials,24707633,115029158,90321525
2016,Nunavut,Pulp and Paper Products,10,80,70
2016,Ontario,Primary Wood Products,66689144,50590685,-16098459
2016,Ontario,Pulp and Paper Products,4528795013,3076073989,-1452721024
2016,Ontario,Wood-Fabricated Materials,1437746263,1734065484,296319221
2016,Prince Edward Island,Pulp and Paper Products,13366,25855602,25842236
2016,Prince Edward Island,Wood-Fabricated Materials,9186,292233,283047
2016,Quebec,Primary Wood Products,335715149,99739945,-235975204
2016,Quebec,Pulp and Paper Products,1272788557,6185704549,4912915992
2016,Quebec,Wood-Fabricated Materials,507459523,3276227496,2768767973
2016,Saskatchewan,Primary Wood Products,902328,3218072,2315744
2016,Saskatchewan,Pulp and Paper Products,28308865,238444672,210135807
2016,Saskatchewan,Wood-Fabricated Materials,27416991,304732829,277315838
2016,Yukon,Primary Wood Products,37,0,-37
2016,Yukon,Pulp and Paper Products,4653,5795,1142
2016,Yukon,Wood-Fabricated Materials,10764,348646,337882
2017,Canada,Primary Wood Products,496704705,1449317830,952613125
2017,Canada,Pulp and Paper Products,7581015353,17613991327,10032975974
2017,Canada,Wood-Fabricated Materials,3317555564,16825383746,13507828182
2017,Alberta,Primary Wood Products,3587929,19988669,16400740
2017,Alberta,Pulp and Paper Products,186198362,1771559087,1585360725
2017,Alberta,Wood-Fabricated Materials,146673435,1674128917,1527455482
2017,British Columbia,Primary Wood Products,71388451,1214525518,1143137067
2017,British Columbia,Pulp and Paper Products,844811343,4425306897,3580495554
2017,British Columbia,Wood-Fabricated Materials,911930319,8365038556,7453108237
2017,Manitoba,Primary Wood Products,5553672,1241166,-4312506
2017,Manitoba,Pulp and Paper Products,367188751,247589482,-119599269
2017,Manitoba,Wood-Fabricated Materials,183289696,228353419,45063723
2017,New Brunswick,Primary Wood Products,62959463,41138508,-21820955
2017,New Brunswick,Pulp and Paper Products,153629495,1108203096,954573601
2017,New Brunswick,Wood-Fabricated Materials,49042952,675567429,626524477
2017,Newfoundland and Labrador,Primary Wood Products,15870,11437,-4433
2017,Newfoundland and Labrador,Pulp and Paper Products,4271229,122037278,117766049
2017,Newfoundland and Labrador,Wood-Fabricated Materials,150980,6244204,6093224
2017,Northwest Territories,Pulp and Paper Products,0,8922,8922
2017,Nova Scotia,Primary Wood Products,14584,22244780,22230196
2017,Nova Scotia,Pulp and Paper Products,22736666,447769962,425033296
2017,Nova Scotia,Wood-Fabricated Materials,26120224,145527602,119407378
2017,Nunavut,Pulp and Paper Products,59,12175,12116
2017,Ontario,Primary Wood Products,61812863,49854664,-11958199
2017,Ontario,Pulp and Paper Products,4655119689,2968921960,-1686197729
2017,Ontario,Wood-Fabricated Materials,1453055739,1907820760,454765021
2017,Prince Edward Island,Pulp and Paper Products,14950,27639816,27624866
2017,Prince Edward Island,Wood-Fabricated Materials,989,480955,479966
2017,Quebec,Primary Wood Products,287288486,98110213,-189178273
2017,Quebec,Pulp and Paper Products,1314108684,6209931615,4895822931
2017,Quebec,Wood-Fabricated Materials,510725187,3490009989,2979284802
2017,Saskatchewan,Primary Wood Products,4083387,2202875,-1880512
2017,Saskatchewan,Pulp and Paper Products,32921283,285011037,252089754
2017,Saskatchewan,Wood-Fabricated Materials,36561760,331939576,295377816
2017,Yukon,Pulp and Paper Products,14842,0,-14842
2017,Yukon,Wood-Fabricated Materials,4283,272339,268056
2018,Canada,Primary Wood Products,588946118,1488964205,900018087
2018,Canada,Pulp and Paper Products,7887195796,20061094320,12173898524
2018,Canada,Wood-Fabricated Materials,3405951158,16953961064,13548009906
2018,Alberta,Primary Wood Products,2211928,21012375,18800447
2018,Alberta,Pulp and Paper Products,203947872,2237950873,2034003001
2018,Alberta,Wood-Fabricated Materials,169788091,1888873715,1719085624
2018,British Columbia,Primary Wood Products,124449105,1246870517,1122421412
2018,British Columbia,Pulp and Paper Products,894519502,5306168650,4411649148
2018,British Columbia,Wood-Fabricated Materials,967713348,8161583214,7193869866
2018,Manitoba,Primary Wood Products,6946385,1578416,-5367969
2018,Manitoba,Pulp and Paper Products,392023881,290896041,-101127840
2018,Manitoba,Wood-Fabricated Materials,197104004,266392441,69288437
2018,New Brunswick,Primary Wood Products,68878452,23755073,-45123379
2018,New Brunswick,Pulp and Paper Products,153216289,1183806089,1030589800
2018,New Brunswick,Wood-Fabricated Materials,44595459,711481319,666885860
2018,Newfoundland and Labrador,Primary Wood Products,2356,9900,7544
2018,Newfoundland and Labrador,Pulp and Paper Products,4478570,167525489,163046919
2018,Newfoundland and Labrador,Wood-Fabricated Materials,95529,18039827,17944298
2018,Northwest Territories,Pulp and Paper Products,0,19733,19733
2018,Nova Scotia,Primary Wood Products,65284,29594280,29528996
2018,Nova Scotia,Pulp and Paper Products,24959400,544463974,519504574
2018,Nova Scotia,Wood-Fabricated Materials,25105367,169763009,144657642
2018,Nunavut,Pulp and Paper Products,0,6625,6625
2018,Ontario,Primary Wood Products,65787894,54837126,-10950768
2018,Ontario,Pulp and Paper Products,4807765010,3022949837,-1784815173
2018,Ontario,Wood-Fabricated Materials,1450751685,1994121916,543370231
2018,Prince Edward Island,Primary Wood Products,9562,0,-9562
2018,Prince Edward Island,Pulp and Paper Products,8658,25786548,25777890
2018,Prince Edward Island,Wood-Fabricated Materials,2854,426498,423644
2018,Quebec,Primary Wood Products,314958567,109093704,-205864863
2018,Quebec,Pulp and Paper Products,1369601220,6926019169,5556417949
2018,Quebec,Wood-Fabricated Materials,528642378,3402084655,2873442277
2018,Saskatchewan,Primary Wood Products,5636585,2212814,-3423771
2018,Saskatchewan,Pulp and Paper Products,36674447,355501292,318826845
2018,Saskatchewan,Wood-Fabricated Materials,22150339,340650348,318500009
2018,Yukon,Pulp and Paper Products,947,0,-947
2018,Yukon,Wood-Fabricated Materials,2104,544122,542018
2019,Canada,Primary Wood Products,580081544,1423361486,843279942
2019,Canada,Pulp and Paper Products,7947262901,17714257540,9766994639
2019,Canada,Wood-Fabricated Materials,3312161542,14025406649,10713245107
2019,Alberta,Primary Wood Products,3378878,27390224,24011346
2019,Alberta,Pulp and Paper Products,199795468,1975687991,1775892523
2019,Alberta,Wood-Fabricated Materials,150396249,1456421758,1306025509
2019,British Columbia,Primary Wood Products,132871238,1153261658,1020390420
2019,British Columbia,Pulp and Paper Products,897447947,4237738480,3340290533
2019,British Columbia,Wood-Fabricated Materials,910364320,6309315328,5398951008
2019,Manitoba,Primary Wood Products,4840701,1015167,-3825534
2019,Manitoba,Pulp and Paper Products,402071516,268668859,-133402657
2019,Manitoba,Wood-Fabricated Materials,167715032,217091064,49376032
2019,New Brunswick,Primary Wood Products,75261247,36763288,-38497959
2019,New Brunswick,Pulp and Paper Products,147690955,1163107419,1015416464
2019,New Brunswick,Wood-Fabricated Materials,41019219,608381362,567362143
2019,Newfoundland and Labrador,Primary Wood Products,17727,19100,1373
2019,Newfoundland and Labrador,Pulp and Paper Products,5141557,156820654,151679097
2019,Newfoundland and Labrador,Wood-Fabricated Materials,98875,18359777,18260902
2019,Northwest Territories,Pulp and Paper Products,95,4039,3944
2019,Nova Scotia,Primary Wood Products,15671,28535514,28519843
2019,Nova Scotia,Pulp and Paper Products,26739105,447165902,420426797
2019,Nova Scotia,Wood-Fabricated Materials,23104204,156895640,133791436
2019,Ontario,Primary Wood Products,68625106,60530936,-8094170
2019,Ontario,Pulp and Paper Products,4825917861,2934833690,-1891084171
2019,Ontario,Wood-Fabricated Materials,1427158087,1775516875,348358788
2019,Prince Edward Island,Pulp and Paper Products,15432,26726669,26711237
2019,Prince Edward Island,Wood-Fabricated Materials,6533,176069,169536
2019,Quebec,Primary Wood Products,290867523,113438058,-177429465
2019,Quebec,Pulp and Paper Products,1389114950,6219990084,4830875134
2019,Quebec,Wood-Fabricated Materials,563286846,3225732743,2662445897
2019,Saskatchewan,Primary Wood Products,4203453,2407541,-1795912
2019,Saskatchewan,Pulp and Paper Products,53326909,283513753,230186844
2019,Saskatchewan,Wood-Fabricated Materials,29004357,256996000,227991643
2019,Yukon,Pulp and Paper Products,1106,0,-1106
2019,Yukon,Wood-Fabricated Materials,7820,520033,512213
2020,Canada,Primary Wood Products,536538538,1118611074,582072536
2020,Canada,Pulp and Paper Products,7763543036,15277502757,7513959721
2020,Canada,Wood-Fabricated Materials,3173453068,16879002535,13705549467
2020,Alberta,Primary Wood Products,7457707,27403666,19945959
2020,Alberta,Pulp and Paper Products,172945619,1652095161,1479149542
2020,Alberta,Wood-Fabricated Materials,137726099,2299192487,2161466388
2020,British Columbia,Primary Wood Products,143527531,856128035,712600504
2020,British Columbia,Pulp and Paper Products,927336349,3427551979,2500215630
2020,British Columbia,Wood-Fabricated Materials,951170444,7023526987,6072356543
2020,Manitoba,Primary Wood Products,6721772,1906713,-4815059
2020,Manitoba,Pulp and Paper Products,453855498,253382621,-200472877
2020,Manitoba,Wood-Fabricated Materials,122098720,294026321,171927601
2020,New Brunswick,Primary Wood Products,55672422,33853155,-21819267
2020,New Brunswick,Pulp and Paper Products,159139823,1027093657,867953834
2020,New Brunswick,Wood-Fabricated Materials,43903522,816949344,773045822
2020,Newfoundland and Labrador,Primary Wood Products,44057,31604,-12453
2020,Newfoundland and Labrador,Pulp and Paper Products,3977519,135390247,131412728
2020,Newfoundland and Labrador,Wood-Fabricated Materials,147226,23577436,23430210
2020,Nova Scotia,Primary Wood Products,26798,24187551,24160753
2020,Nova Scotia,Pulp and Paper Products,33045378,269329005,236283627
2020,Nova Scotia,Wood-Fabricated Materials,25677549,204786881,179109332
2020,Nunavut,Pulp and Paper Products,411,0,-411
2020,Ontario,Primary Wood Products,70405034,55484655,-14920379
2020,Ontario,Pulp and Paper Products,4657072797,2781744332,-1875328465
2020,Ontario,Wood-Fabricated Materials,1369242399,2048618438,679376039
2020,Prince Edward Island,Pulp and Paper Products,29094,28480546,28451452
2020,Prince Edward Island,Wood-Fabricated Materials,11328,275769,264441
2020,Quebec,Primary Wood Products,246587373,115927689,-130659684
2020,Quebec,Pulp and Paper Products,1285077577,5461326590,4176249013
2020,Quebec,Wood-Fabricated Materials,499969558,3731307725,3231338167
2020,Saskatchewan,Primary Wood Products,6095844,3688006,-2407838
2020,Saskatchewan,Pulp and Paper Products,71062971,241108619,170045648
2020,Saskatchewan,Wood-Fabricated Materials,23505638,436630565,413124927
2020,Yukon,Wood-Fabricated Materials,585,110582,109997
2021,Canada,Primary Wood Products,538461202,1351959257,813498055
2021,Canada,Pulp and Paper Products,8117724743,16709983929,8592259186
2021,Canada,Wood-Fabricated Materials,4294357968,26906723043,22612365075
2021,Alberta,Primary Wood Products,6151353,24356719,18205366
2021,Alberta,Pulp and Paper Products,177693242,1795481087,1617787845
2021,Alberta,Wood-Fabricated Materials,154463371,4105490854,3951027483
2021,British Columbia,Primary Wood Products,105711390,1020977812,915266422
2021,British Columbia,Pulp and Paper Products,1032285197,3957832374,2925547177
2021,British Columbia,Wood-Fabricated Materials,1329650922,11202772317,9873121395
2021,Manitoba,Primary Wood Products,10418345,1614690,-8803655
2021,Manitoba,Pulp and Paper Products,476172192,352654473,-123517719
2021,Manitoba,Wood-Fabricated Materials,148526078,322954709,174428631
2021,New Brunswick,Primary Wood Products,52310589,63892347,11581758
2021,New Brunswick,Pulp and Paper Products,181023135,1189119590,1008096455
2021,New Brunswick,Wood-Fabricated Materials,63050593,1179361745,1116311152
2021,Newfoundland and Labrador,Primary Wood Products,0,877688,877688
2021,Newfoundland and Labrador,Pulp and Paper Products,4212284,144457757,140245473
2021,Newfoundland and Labrador,Wood-Fabricated Materials,33530,44325289,44291759
2021,Northwest Territories,Pulp and Paper Products,0,4649,4649
2021,Northwest Territories,Wood-Fabricated Materials,2,0,-2
2021,Nova Scotia,Primary Wood Products,32232,40984899,40952667
2021,Nova Scotia,Pulp and Paper Products,39877209,298697756,258820547
2021,Nova Scotia,Wood-Fabricated Materials,29175054,275209623,246034569
2021,Ontario,Primary Wood Products,80902010,53140348,-27761662
2021,Ontario,Pulp and Paper Products,4806300121,2772801315,-2033498806
2021,Ontario,Wood-Fabricated Materials,1860020763,3152768394,1292747631
2021,Prince Edward Island,Primary Wood Products,0,64,64
2021,Prince Edward Island,Pulp and Paper Products,40497,24234800,24194303
2021,Prince Edward Island,Wood-Fabricated Materials,9,164986,164977
2021,Quebec,Primary Wood Products,273359622,142340150,-131019472
2021,Quebec,Pulp and Paper Products,1331757140,5953163533,4621406393
2021,Quebec,Wood-Fabricated Materials,672473599,5752322035,5079848436
2021,Saskatchewan,Primary Wood Products,9575661,3774540,-5801121
2021,Saskatchewan,Pulp and Paper Products,68363726,221536595,153172869
2021,Saskatchewan,Wood-Fabricated Materials,36964047,870933546,833969499
2021,Yukon,Wood-Fabricated Materials,0,419545,419545
2022,Canada,Primary Wood Products,552636197,1570336761,1017700564
2022,Canada,Pulp and Paper Products,10023644896,19879229589,9855584693
2022,Canada,Wood-Fabricated Materials,4523218928,24122220953,19599002025
2022,Alberta,Primary Wood Products,5994713,36271408,30276695
2022,Alberta,Pulp and Paper Products,209541293,2179221409,1969680116
2022,Alberta,Wood-Fabricated Materials,149554574,3445886953,3296332379
2022,British Columbia,Primary Wood Products,114594306,1141514436,1026920130
2022,British Columbia,Pulp and Paper Products,1337457711,4441047463,3103589752
2022,British Columbia,Wood-Fabricated Materials,1394425565,9751062352,8356636787
2022,Manitoba,Primary Wood Products,7820988,1593322,-6227666
2022,Manitoba,Pulp and Paper Products,605952259,346224374,-259727885
2022,Manitoba,Wood-Fabricated Materials,213721883,389844070,176122187
2022,New Brunswick,Primary Wood Products,57808658,76846696,19038038
2022,New Brunswick,Pulp and Paper Products,227570232,1439373511,1211803279
2022,New Brunswick,Wood-Fabricated Materials,63732938,1162367577,1098634639
2022,Newfoundland and Labrador,Primary Wood Products,1140,20811,19671
2022,Newfoundland and Labrador,Pulp and Paper Products,6896103,195923807,189027704
2022,Newfoundland and Labrador,Wood-Fabricated Materials,86140,37964401,37878261
2022,Nova Scotia,Primary Wood Products,41671,35785571,35743900
2022,Nova Scotia,Pulp and Paper Products,36740994,330586207,293845213
2022,Nova Scotia,Wood-Fabricated Materials,27902941,249612289,221709348
2022,Ontario,Primary Wood Products,85649768,66119298,-19530470
2022,Ontario,Pulp and Paper Products,5839537894,3267482204,-2572055690
2022,Ontario,Wood-Fabricated Materials,1954005603,3033675892,1079670289
2022,Prince Edward Island,Pulp and Paper Products,58750,38512904,38454154
2022,Prince Edward Island,Wood-Fabricated Materials,19283,61277,41994
2022,Quebec,Primary Wood Products,274681140,208060886,-66620254
2022,Quebec,Pulp and Paper Products,1679248361,7306376924,5627128563
2022,Quebec,Wood-Fabricated Materials,672258229,5404936228,4732677999
2022,Saskatchewan,Primary Wood Products,6043813,4124333,-1919480
2022,Saskatchewan,Pulp and Paper Products,80641227,334480786,253839559
2022,Saskatchewan,Wood-Fabricated Materials,47511772,646497219,598985447
2022,Yukon,Pulp and Paper Products,72,0,-72
2022,Yukon,Wood-Fabricated Materials,0,312695,312695
2023,Canada,Primary Wood Products,609228615,1474773767,865545152
2023,Canada,Pulp and Paper Products,9764775477,18162505479,8397730002
2023,Canada,Wood-Fabricated Materials,3879950408,16574905579,12694955171
2023,Alberta,Primary Wood Products,10419158,42019320,31600162
2023,Alberta,Pulp and Paper Products,256488058,1827949473,1571461415
2023,Alberta,Wood-Fabricated Materials,168838125,1975829166,1806991041
2023,British Columbia,Primary Wood Products,145549725,1025407816,879858091
2023,British Columbia,Pulp and Paper Products,1186307489,3636376530,2450069041
2023,British Columbia,Wood-Fabricated Materials,1141563766,6392559988,5250996222
2023,Manitoba,Primary Wood Products,10001804,1718797,-8283007
2023,Manitoba,Pulp and Paper Products,638720615,316108625,-322611990
2023,Manitoba,Wood-Fabricated Materials,181271676,407820504,226548828
2023,New Brunswick,Primary Wood Products,89972885,86870785,-3102100
2023,New Brunswick,Pulp and Paper Products,207964530,1403672873,1195708343
2023,New Brunswick,Wood-Fabricated Materials,55110329,797384764,742274435
2023,Newfoundland and Labrador,Primary Wood Products,284,657,373
2023,Newfoundland and Labrador,Pulp and Paper Products,5517192,174849197,169332005
2023,Newfoundland and Labrador,Wood-Fabricated Materials,82026,22283711,22201685
2023,Northwest Territories,Pulp and Paper Products,0,38,38
2023,Nova Scotia,Primary Wood Products,17303,41998751,41981448
2023,Nova Scotia,Pulp and Paper Products,34178997,288390768,254211771
2023,Nova Scotia,Wood-Fabricated Materials,27294647,169834288,142539641
2023,Nunavut,Pulp and Paper Products,0,19,19
2023,Nunavut,Wood-Fabricated Materials,0,71507,71507
2023,Ontario,Primary Wood Products,99182109,60519379,-38662730
2023,Ontario,Pulp and Paper Products,5830855287,3331451503,-2499403784
2023,Ontario,Wood-Fabricated Materials,1744632905,2419693999,675061094
2023,Prince Edward Island,Pulp and Paper Products,62652,42508909,42446257
2023,Prince Edward Island,Wood-Fabricated Materials,1319,82802,81483
2023,Quebec,Primary Wood Products,245060378,212208671,-32851707
2023,Quebec,Pulp and Paper Products,1524190446,6841684561,5317494115
2023,Quebec,Wood-Fabricated Materials,515122386,4010123001,3495000615
2023,Saskatchewan,Primary Wood Products,9024969,4029591,-4995378
2023,Saskatchewan,Pulp and Paper Products,80489962,299512983,219023021
2023,Saskatchewan,Wood-Fabricated Materials,46033202,378633554,332600352
2023,Yukon,Pulp and Paper Products,249,0,-249
2023,Yukon,Wood-Fabricated Materials,27,588295,588268
